{
    "28694654403": {
        "good": [
            "25672393973",
            "28003167646",
            "11597289597",
            "28254128851",
            "25590369054",
            "30381491103",
            "28146173725"
        ],
        "bad": [],
        "medium": [
            "27822944466",
            "5012752"
        ]
    },
    "7271145": {
        "good": [
            "11597289597",
            "30531612513",
            "28972958451",
            "30250518223",
            "7806092",
            "25552148393",
            "27867433214",
            "7118574",
            "29754712999",
            "28685301550",
            "11597289597",
            "28387220674",
            "13826164806",
            "11597289597",
            "25808357455"
        ],
        "bad": [
            "22839698565",
            "13826164806",
            "6742381",
            "25382820925",
            "27579367499",
            "13826164806",
            "22839698565",
            "27065176046"
        ],
        "medium": [
            "29366393263",
            "30584633157",
            "27214249695",
            "25382820925"
        ]
    }
}